1111111111111111111111111
1P00000011111111111110001
1001100010000000000C00001
100110e010000e0000e001001
1000000010000000000000001
111C000000000000001111111
1111011110111100001111111
1000000010000000000000001
10e000001000000E0000e0001
10000C001000000000e000001
1000e0001C00000e000000001
1111000000000000001111111
1111000010111100001111111
1000000010000C00000000001
1000000010000000000000001
1000000010000e0000e000001
1e01100010000000000000001
10000C00100000000000C0001
1000000010000C00000000001
10000e0010000000000000001
1000000011111111111110001
1111111111111111111111111
