1111111111111111111111111
100000C000000000000000C01
1000000000000000000001101
100000e000000000000000001
1111101110000000000000011
1C00001010000000000000001
1011101010000000000000001
1e00000000000000000000e01
1011101010000000000011101
1000001010000000000000001
1000001010000000000000001
1000000000000000000000C01
1000000E00000000000000001
1000000000000000000000001
100000101000000e000000001
1111101110000000000000011
100C00e000000000000000001
100000C0000000000000C0001
1e000000000000000000000P1
1111111111111111111111111
