111111111111111111111111
1000000P00000000C0000001
111111111000000e00000001
100000000011111111100001
10e00C001000000000000e01
100000001000111111111111
100011111000100000000001
1000100e1000100C0000E001
100010001000000e00000001
1C0010001000100000ee0001
100010001000111111111111
1000000010e0000000000C01
100e100010000000e0001111
111110001111111111000001
100000e01000000001000001
10C000001000C00001000e01
100000e01000000001000001
111100111000000001000C01
10000000100e000000000001
1C00000010000000010e0001
100000001000e00001000001
111111111111111111111111
