111111111111111111111111
111P00000000000000000001
110000000011111110011101
100001111110000000000111
10e1100000000e00C0000001
1111000e00000000000000e1
100000000000000011111011
1111111111111001e0000001
1000000e00010e0010000001
1000000000010C00100C0001
1000000C0001000010000001
100e0000000011111111e001
10000e000000000000010001
100000000000000000010001
110010111111110000010001
100000100E0e010000010001
100000100000010000010001
1e0000100111110000010001
10C00010C010000000010001
100000100000000000010001
10000e111110000000000111
111111111111111111111111
