111111111111111111111111
1P0000000000000000000001
100011111100000000001111
100000000011111110000001
1000e00000000000e0000001
100000111111000000000001
1e0000000001111111100001
100011111001000000000e01
100010001001000000000001
1111100010010000e0000001
100010001001000000000001
11011001001111111111e001
100010010000000000000001
100010010E00000000000001
100010010000000000C00001
11000100100000000e000001
100010e10000000000000001
100000000011111110000001
1000000000000000e0000001
100001111100000000000001
10e000000000000000000e01
111111111111111111111111
